(0,0,1,2,1,)
(1,0,1,4,0,)
(2,0,1,3,0,)
(3,0,2,0,0,)
(4,0,1,2,1,)
(5,0,2,0,1,)
(6,0,0,1,1,)
(7,0,0,2,0,)
(8,0,0,2,0,)
(9,0,2,3,0,)
(10,0,2,1,1,)
(11,0,1,4,0,)
(12,0,1,4,1,)
(13,0,0,3,0,)
(14,0,0,3,0,)
(15,0,1,1,0,)
(16,0,2,3,1,)
(17,0,0,2,0,)
(18,0,2,4,1,)
(19,0,1,4,1,)
(20,0,2,0,0,)
(21,0,1,3,0,)
(22,0,1,2,0,)
(23,0,0,1,0,)
(24,0,1,4,0,)
(25,0,0,1,0,)
(26,0,0,3,1,)
(27,0,1,4,1,)
(28,0,1,0,0,)
(29,0,1,1,0,)
(30,0,2,4,0,)
(31,0,1,2,1,)
(32,0,0,2,0,)
(33,0,2,3,1,)
(34,0,0,3,1,)
(35,0,2,2,0,)
(0,1,2,1,1,)
(1,1,1,4,1,)
(2,1,2,4,0,)
(3,1,0,2,1,)
(4,1,2,0,0,)
(5,1,2,0,0,)
(6,1,2,4,1,)
(7,1,1,0,0,)
(8,1,1,4,1,)
(9,1,2,2,0,)
(10,1,1,2,1,)
(11,1,0,3,1,)
(12,1,1,4,1,)
(13,1,0,1,0,)
(14,1,2,1,0,)
(15,1,2,3,0,)
(16,1,0,1,0,)
(17,1,2,0,1,)
(18,1,2,2,0,)
(19,1,0,0,1,)
(20,1,1,0,0,)
(21,1,1,4,0,)
(22,1,0,1,0,)
(23,1,1,3,1,)
(24,1,2,4,1,)
(25,1,2,3,1,)
(26,1,1,3,0,)
(27,1,1,3,1,)
(28,1,2,3,0,)
(29,1,2,0,1,)
(30,1,2,4,1,)
(31,1,0,0,0,)
(32,1,1,4,0,)
(33,1,0,3,0,)
(34,1,0,3,0,)
(35,1,2,4,1,)
(0,2,0,0,1,)
(1,2,0,3,1,)
(2,2,2,3,0,)
(3,2,0,3,0,)
(4,2,2,1,0,)
(5,2,2,4,1,)
(6,2,0,2,1,)
(7,2,1,3,0,)
(8,2,1,4,0,)
(9,2,2,3,1,)
(10,2,1,3,1,)
(11,2,0,2,1,)
(12,2,0,0,0,)
(13,2,2,2,0,)
(14,2,1,3,1,)
end